0 0 0 0 0 0 0 0 0 0 0 0 0 0 0 0 0 0 0 0 0 0 0 0 0 0 0 0 0 0 0 0 0 0 0 0 0 0 0 0 0 0 0 0 0 0 0 0 0 0
0 0 0 0 0 0 0 0 0 0 0 0 0 0 0 0 0 0 0 0 0 0 0 0 0 0 0 0 0 0 0 0 0 0 0 0 0 0 0 0 0 0 0 0 0 0 0 0 0 0
0 0 0 0 0 0 0 0 0 0 0 0 0 0 0 0 0 0 0 0 0 0 0 0 0 0 0 0 0 0 0 0 0 0 0 0 0 0 0 0 0 0 0 0 0 0 0 0 0 0
0 0 0 0 7 7 7 7 7 7 7 7 7 7 7 7 7 7 7 7 7 7 7 7 7 7 7 7 7 7 7 7 7 7 7 7 7 7 7 7 7 7 7 7 7 7 0 0 0 0
0 0 0 6 12 2 30 2 2 27 27 27 27 27 2 2 2 2 2 2 2 2 2 2 2 2 2 2 2 2 2 2 2 2 2 2 2 2 2 2 2 2 2 2 2 2 3 0 0 0
0 0 0 6 19 15 15 2 2 27 27 27 27 14 1 1 1 1 1 1 1 1 1 1 1 1 1 1 1 1 1 1 1 1 1 1 1 34 35 1 1 1 1 1 1 2 3 0 0 0
0 0 0 6 34 35 12 2 2 2 2 27 2 14 1 1 1 1 1 1 1 1 1 1 1 1 29 29 29 29 1 1 1 1 1 1 1 36 37 1 1 1 1 1 1 2 3 0 0 0
0 0 0 6 36 37 12 2 2 2 2 2 2 14 1 1 1 1 1 1 1 1 1 1 1 1 1 29 29 29 29 1 1 1 1 1 1 1 1 1 1 1 1 1 1 2 3 0 0 0
0 0 0 6 27 13 13 2 2 2 2 2 2 14 1 1 1 1 16 13 13 13 17 1 1 1 1 1 1 1 1 1 1 16 13 13 13 13 13 13 13 13 13 17 1 2 3 0 0 0
0 0 0 6 27 2 2 2 2 2 2 2 2 14 1 1 1 1 13 27 27 14 1 1 1 1 1 1 1 1 1 1 1 12 8 4 4 4 4 4 4 4 9 14 1 2 3 0 0 0
0 0 0 6 2 2 21 2 2 2 2 2 2 14 1 1 1 1 1 1 13 27 27 17 1 1 1 1 1 1 1 1 1 12 3 0 0 0 0 0 0 0 6 14 1 2 3 0 0 0
0 0 0 6 2 2 2 2 29 29 29 29 2 14 1 1 1 1 1 1 1 1 1 1 1 1 1 1 1 1 1 1 1 12 11 7 7 7 7 7 7 7 10 14 1 2 3 0 0 0
0 0 0 6 8 4 4 9 29 29 29 29 8 4 9 1 1 1 1 1 1 8 4 4 4 4 4 4 4 4 9 1 1 19 15 15 15 15 15 15 15 15 15 18 1 2 3 0 0 0
0 0 0 0 0 0 0 0 4 4 4 4 0 0 6 1 1 1 1 1 1 3 0 0 0 0 0 0 0 0 6 1 1 1 1 1 1 1 1 1 1 1 1 1 28 2 3 0 0 0
0 0 0 6 11 7 7 7 7 7 7 7 7 7 10 1 1 1 1 1 1 11 7 7 7 7 7 7 7 7 10 1 1 1 1 1 1 1 1 1 1 28 28 1 1 2 3 0 0 0
0 0 0 6 2 1 1 1 1 1 1 1 1 1 1 1 1 1 1 1 1 1 1 1 1 1 1 1 1 1 1 1 1 1 1 1 1 1 1 1 1 1 1 1 28 2 3 0 0 0
0 0 0 6 2 1 1 1 1 1 1 1 1 1 1 1 1 1 1 1 1 1 1 1 1 1 1 1 1 1 1 1 1 1 1 1 1 1 1 1 1 1 1 1 1 2 3 0 0 0
0 0 0 6 2 8 4 4 4 4 4 4 4 9 14 1 1 1 1 1 1 1 1 1 1 1 1 1 1 1 1 1 28 28 28 28 1 1 1 1 1 1 1 1 1 2 3 0 0 0
0 0 0 6 2 11 7 7 7 7 7 7 7 10 14 1 1 1 1 1 1 1 1 16 13 13 13 17 1 1 1 28 28 28 28 1 1 1 1 1 1 12 27 27 27 2 3 0 0 0
0 0 0 6 2 1 1 1 1 1 1 1 1 1 1 1 1 1 1 1 1 1 1 12 32 32 32 14 1 1 1 1 8 9 1 1 1 1 1 1 1 1 1 12 27 2 3 0 0 0
0 0 0 6 2 1 1 1 1 1 1 1 1 1 1 1 1 1 1 1 1 1 1 19 15 15 15 18 1 1 1 1 11 10 1 1 1 1 1 1 1 1 1 1 1 2 3 0 0 0
0 0 0 6 2 1 1 8 9 1 1 1 1 1 1 1 1 1 1 1 1 1 1 1 1 1 1 1 1 1 1 1 1 1 1 1 1 1 1 1 1 1 1 33 1 2 3 0 0 0 0
0 0 0 6 2 1 1 11 10 1 1 28 28 28 28 1 1 1 1 1 16 13 13 13 13 13 13 13 13 13 17 1 1 1 1 1 1 1 1 1 1 1 1 1 1 2 3 0 0 0
0 0 0 6 2 1 1 28 28 28 28 1 1 1 1 34 35 1 1 1 12 8 4 4 4 4 4 4 4 9 14 1 34 35 1 1 1 1 1 1 1 1 1 1 1 2 3 0 0 0
0 0 0 6 2 1 1 1 1 28 28 28 28 1 1 36 37 1 1 1 12 3 0 0 0 0 0 0 0 6 14 1 36 37 1 1 1 1 1 1 1 1 1 1 1 2 3 0 0 0
0 0 0 6 2 1 1 1 1 1 1 1 1 1 1 1 1 1 1 1 12 3 0 0 0 0 0 0 0 6 14 1 1 1 1 1 20 1 8 9 1 8 9 1 1 2 3 0 0 0
0 0 0 6 8 4 4 4 4 4 9 1 1 1 1 1 1 1 20 1 12 3 0 0 0 0 0 0 0 6 14 1 1 1 1 1 1 1 3 6 1 11 10 1 1 2 3 0 0 0
0 0 0 6 3 0 0 0 0 0 6 1 1 1 1 1 1 1 1 1 12 3 0 0 0 0 0 0 0 6 14 1 1 1 1 1 1 1 3 6 1 1 1 1 1 2 3 0 0 0
0 0 0 6 3 0 0 0 7 7 10 1 1 1 1 1 1 1 1 1 12 11 7 7 7 7 7 7 7 10 14 1 1 1 1 1 1 1 3 6 1 1 26 1 33 2 3 0 0 0
0 0 0 6 3 0 0 0 4 4 4 9 1 1 1 1 1 1 1 1 19 15 15 15 15 15 15 15 15 15 18 1 1 1 1 1 1 1 3 6 26 1 1 1 26 2 3 0 0 0
0 0 0 6 11 7 7 7 7 7 7 10 1 1 1 1 1 1 1 1 16 13 13 13 13 13 13 13 13 13 17 1 1 1 1 1 1 1 3 6 1 1 1 1 1 2 3 0 0 0
0 0 0 6 2 1 1 1 1 1 1 1 1 1 1 1 1 1 1 1 12 8 4 4 4 4 4 4 4 9 14 1 1 1 1 1 1 1 3 6 1 1 1 1 1 2 3 0 0 0
0 0 0 6 8 4 4 9 1 1 1 1 1 1 1 1 1 1 1 1 12 3 0 0 0 0 0 0 0 6 14 1 1 26 26 1 1 1 3 6 1 1 1 1 1 2 3 0 0 0
0 0 0 6 3 0 0 6 1 1 1 1 1 1 1 1 1 1 1 1 12 3 0 0 0 0 0 0 0 6 14 1 1 26 26 1 1 1 3 6 1 1 1 1 1 2 3 0 0 0
0 0 0 6 3 0 0 0 4 9 1 1 1 1 1 1 20 1 1 1 12 3 0 0 0 0 0 0 0 6 14 1 26 26 1 1 1 1 11 10 1 8 9 1 1 2 3 0 0 0
0 0 0 6 3 0 0 0 0 6 1 1 1 1 1 1 1 1 1 1 12 3 0 0 0 0 0 0 0 6 14 1 1 1 1 1 1 1 1 1 1 11 10 1 1 2 3 0 0 0
0 0 0 6 11 7 7 7 7 10 1 1 1 1 1 26 1 1 1 1 12 11 7 7 7 7 7 7 7 10 14 1 1 1 1 1 1 1 1 1 1 1 1 1 1 2 3 0 0 0
0 0 0 6 2 1 1 1 1 1 1 1 1 1 26 1 1 1 1 1 19 15 15 15 15 15 15 15 15 15 18 1 1 1 1 1 1 1 28 28 28 28 1 1 1 2 3 0 0 0
0 0 0 6 2 1 1 1 1 1 1 26 26 1 1 1 1 1 1 1 1 1 1 1 1 1 1 1 1 1 1 1 1 1 1 1 1 1 1 28 28 1 1 1 1 2 3 0 0 0
0 0 0 6 2 1 1 1 1 1 1 26 26 1 1 1 1 1 28 28 28 28 1 1 1 1 1 1 1 1 28 1 1 1 1 1 1 1 1 28 28 1 1 1 1 2 3 0 0 0
0 0 0 6 2 1 1 1 1 1 1 1 1 1 1 1 1 1 1 1 1 1 1 1 1 1 1 1 1 1 28 1 1 1 1 1 1 1 1 28 28 1 1 1 1 2 3 0 0 0
0 0 0 6 2 1 1 1 1 1 1 1 1 1 1 1 1 8 9 1 1 1 1 31 33 31 1 1 1 28 28 28 1 1 1 34 35 1 1 28 28 1 1 1 1 2 3 0 0 0
0 0 0 6 2 1 1 34 35 1 1 31 1 1 1 1 1 11 10 1 1 1 1 1 1 1 1 1 1 28 1 1 1 1 1 36 37 1 1 1 1 1 1 1 1 2 3 0 0 0
0 0 0 6 2 1 1 36 37 1 1 1 1 1 1 1 1 1 1 1 1 1 1 1 1 1 1 1 1 1 28 1 1 1 1 1 1 1 1 1 1 1 1 1 1 2 3 0 0 0
0 0 0 6 2 1 1 1 1 1 1 1 1 1 1 1 1 1 1 1 1 1 1 1 1 20 1 1 1 1 1 1 1 1 1 1 1 1 1 1 33 1 1 1 1 2 3 0 0 0
0 0 0 6 2 2 2 2 2 2 2 2 2 2 2 2 2 2 2 2 2 2 2 2 2 2 2 2 2 2 2 2 2 2 2 2 2 2 2 2 2 2 2 2 2 2 3 0 0 0
0 0 0 0 4 4 4 4 4 4 4 4 4 4 4 4 4 4 4 4 4 4 4 4 4 4 4 4 4 4 4 4 4 4 4 4 4 4 4 4 4 4 4 4 4 4 0 0 0 0
0 0 0 0 0 0 0 0 0 0 0 0 0 0 0 0 0 0 0 0 0 0 0 0 0 0 0 0 0 0 0 0 0 0 0 0 0 0 0 0 0 0 0 0 0 0 0 0 0 0
0 0 0 0 0 0 0 0 0 0 0 0 0 0 0 0 0 0 0 0 0 0 0 0 0 0 0 0 0 0 0 0 0 0 0 0 0 0 0 0 0 0 0 0 0 0 0 0 0 0
0 0 0 0 0 0 0 0 0 0 0 0 0 0 0 0 0 0 0 0 0 0 0 0 0 0 0 0 0 0 0 0 0 0 0 0 0 0 0 0 0 0 0 0 0 0 0 0 0 0
